tip.name	current.accepted.name	duplicated
Acnistus_arborescens	Acnistus_arborescens	no
Anisodus_acutangulus	Anisodus_acutangulus	no
Anisodus_carniolicoides	Anisodus_carniolicoides	no
Anisodus_luridus	Anisodus_luridus	no
Anisodus_tanguticus	Anisodus_tanguticus	no
Anthocercis_angustifolia	Anthocercis_angustifolia	no
Anthocercis_gracilis	Anthocercis_gracilis	no
Anthocercis_ilicifolia	Anthocercis_ilicifolia	no
Anthocercis_intricata	Anthocercis_intricata	no
Anthocercis_littorea	Anthocercis_littorea	no
Anthocercis_myosotidea	Cyphanthera_myosotidea	no
Anthocercis_racemosa	Cyphanthera_racemosa	no
Anthocercis_sylvicola	Anthocercis_sylvicola	no
Anthocercis_viscosa	Anthocercis_viscosa	no
Anthotroche_blackii	Anthotroche_pannosa	yes
Anthotroche_myoporoides	Anthotroche_myoporoides	no
Anthotroche_pannosa	Anthotroche_pannosa	no
Anthotroche_walcottii	Anthotroche_walcottii	no
Athenaea_pogogena	Athenaea_pogogena	no
Athenaea_sp	Athenaea_sp	no
Atropa_belladonna	Atropa_belladonna	no
Atropa_komarovii	Atropa_komarovii	no
Atropanthe_sinensis	Atropanthe_sinensis	no
Aureliana_fasciculata	Aureliana_fasciculata	no
Benthamiella_patagonica	Benthamiella_patagonica	no
Benthamiella_skottsbergii	Benthamiella_skottsbergii	no
Bouchetia_anomala	Bouchetia_anomala	no
Bouchetia_erecta	Bouchetia_erecta	no
Brachistus_stramoniifolius	Brachistus_stramoniifolius	no
Browallia_eludens	Browallia_eludens	no
Browallia_speciosa	Browallia_speciosa	no
Brugmansia_arborea	Brugmansia_arborea	no
Brugmansia_aurea	Brugmansia_aurea	no
Brugmansia_sanguinea	Brugmansia_sanguinea	no
Brunfelsia_americana	Brunfelsia_americana	no
Brunfelsia_uniflora	Brunfelsia_uniflora	no
Calibrachoa_parviflora	Calibrachoa_parviflora	no
Calibrachoa_pygmaea	Calibrachoa_pygmaea	no
Calibrachoa_sellowiana	Calibrachoa_sellowiana	no
Capsicum_annuum	Capsicum_annuum	no
Capsicum_baccatum	Capsicum_baccatum	no
Capsicum_campylopodium	Capsicum_campylopodium	no
Capsicum_cardenasii	Capsicum_cardenasii	no
Capsicum_ceratocalyx	Capsicum_ceratocalyx	no
Capsicum_chacoense	Capsicum_chacoense	no
Capsicum_chinense	Capsicum_chinense	no
Capsicum_ciliatum	Capsicum_ciliatum	no
Capsicum_coccineum	Capsicum_coccineum	no
Capsicum_eximium	Capsicum_eximium	no
Capsicum_flexuosum	Capsicum_flexuosum	no
Capsicum_frutescens	Capsicum_frutescens	no
Capsicum_galapagoense	Capsicum_galapagoense	no
Capsicum_geminifolium	Capsicum_geminifolium	no
Capsicum_hunzikerianum	Capsicum_hunzikerianum	no
Capsicum_lanceolatum	Capsicum_lanceolatum	no
Capsicum_lycianthoides	Capsicum_lycianthoides	no
Capsicum_minutiflorum	Capsicum_minutiflorum	no
Capsicum_pereirae	Capsicum_pereirae	no
Capsicum_pubescens	Capsicum_pubescens	no
Capsicum_recurvatum	Capsicum_recurvatum	no
Capsicum_rhomboideum	Capsicum_rhomboideum	no
Capsicum_schottianum	Capsicum_schottianum	no
Capsicum_tovarii	Capsicum_tovarii	no
Capsicum_villosum	Capsicum_villosum	no
Cestrum_acutifolium	Cestrum_acutifolium	no
Cestrum_aurantiacum	Cestrum_aurantiacum	no
Cestrum_chiriquianum	Cestrum_chiriquianum	no
Cestrum_dasyanthum	Cestrum_dasyanthum	no
Cestrum_diurnum	Cestrum_diurnum	no
Cestrum_elegans	Cestrum_elegans	no
Cestrum_endlicheri	Cestrum_endlicheri	no
Cestrum_fasciculatum	Cestrum_fasciculatum	no
Cestrum_fragile	Cestrum_fragile	no
Cestrum_fulvescens	Cestrum_fulvescens	no
Cestrum_glanduliferum	Cestrum_glanduliferum	no
Cestrum_guatemalense	Cestrum_guatemalense	no
Cestrum_inclusum	Cestrum_inclusum	no
Cestrum_irazuense	Cestrum_irazuense	no
Cestrum_laxum	Cestrum_laxum	no
Cestrum_luteovirescens	Cestrum_luteovirescens	no
Cestrum_macrophyllum	Cestrum_macrophyllum	no
Cestrum_megalophyllum	Cestrum_megalophyllum	no
Cestrum_milciomejiae	Cestrum_milciomejiae	no
Cestrum_miradorense	Cestrum_miradorense	no
Cestrum_mortonianum	Cestrum_mortonianum	no
Cestrum_nocturnum	Cestrum_nocturnum	no
Cestrum_oblongifolium	Cestrum_oblongifolium	no
Cestrum_pacayense	Cestrum_pacayense	no
Cestrum_pittieri	Cestrum_sp	no
Cestrum_poasanum	Cestrum_poasanum	no
Cestrum_regelii	Cestrum_regelii	no
Cestrum_rigidum	Cestrum_rigidum	no
Cestrum_roseum	Cestrum_roseum	no
Cestrum_sphaerocarpum	Cestrum_sphaerocarpum	no
Cestrum_strigilatum	Cestrum_strigilatum	no
Cestrum_thyrsoideum	Cestrum_thyrsoideum	no
Cestrum_tomentosum	Cestrum_tomentosum	no
Cestrum_tuerckheimii	Cestrum_tuerckheimii	no
Cestrum_violaceum	Cestrum_violaceum	no
Cestrum_virgaurea	Cestrum_virgaurea	no
Chamaesaracha_coronopus	Chamaesaracha_coronopus	no
Chamaesaracha_sordida	Chamaesaracha_sordida	no
Coeloneurum_ferrugineum	Coeloneurum_ferrugineum	no
Combera_paradoxa	Combera_paradoxa	no
Crenidium_spinescens	Crenidium_spinescens	no
Cuatresia_exiguiflora	Cuatresia_exiguiflora	no
Cuatresia_riparia	Cuatresia_riparia	no
Cyphanthera_albicans	Cyphanthera_albicans	no
Cyphanthera_anthocercidea	Cyphanthera_anthocercidea	no
Cyphanthera_microphylla	Cyphanthera_microphylla	no
Cyphanthera_odgersii	Cyphanthera_odgersii	no
Datura_bernhardii	Datura_bernhardii	no
Datura_ceratocaula	Datura_ceratocaula	no
Datura_discolor	Datura_discolor	no
Datura_ferox	Datura_ferox	no
Datura_inoxia	Datura_inoxia	no
Datura_laevis	Datura_stramonium	yes
Datura_leichhardtii	Datura_leichhardtii	no
Datura_metel	Datura_metel	no
Datura_quercifolia	Datura_quercifolia	no
Datura_rosei	Datura_sp	no
Datura_stramonium	Datura_stramonium	no
Deprea_bitteriana	Deprea_bitteriana	no
Deprea_orinocensis	Deprea_orinocensis	no
Deprea_paneroi	Deprea_paneroi	no
Deprea_sylvaticum	Deprea_sylvarum	yes
Discopodium_penninervium	Discopodium_penninervium	no
Duboisia_hopwoodii	Duboisia_hopwoodii	no
Duboisia_leichhardtii	Duboisia_leichhardtii	no
Duboisia_myoporoides	Duboisia_myoporoides	no
Duckeodendron_cestroides	Duckeodendron_cestroides	no
Dunalia_brachyacantha	Dunalia_brachyacantha	no
Dunalia_obovata	Dunalia_obovata	no
Dunalia_solanacea	Dunalia_solanacea	no
Dunalia_spathulata	Dunalia_spathulata	no
Dunalia_spinosa	Dunalia_spinosa	no
Dyssochroma_viridiflora	Dyssochroma_viridiflora	no
Eriolarynx_fasciculata	Eriolarynx_fasciculata	no
Eriolarynx_lorentzii	Eriolarynx_lorentzii	no
Espadaea_amoena	Espadaea_amoena	no
Exodeconus_miersii	Exodeconus_miersii	no
Fabiana_imbricata	Fabiana_imbricata	no
Goetzea_ekmanii	Goetzea_ekmanii	no
Goetzea_elegans	Goetzea_elegans	no
Grammosolen_dixonii	Grammosolen_dixonii	no
Grammosolen_truncatus	Grammosolen_truncatus	no
Henoonia_myrtifolia	Henoonia_myrtifolia	no
Heteranthia_decipiens	Heteranthia_decipiens	no
Hunzikeria_texana	Hunzikeria_texana	no
Hyoscyamus_albus	Hyoscyamus_albus	no
Hyoscyamus_aureus	Hyoscyamus_aureus	no
Hyoscyamus_desertorum	Hyoscyamus_desertorum	no
Hyoscyamus_leptocalyx	Hyoscyamus_leptocalyx	no
Hyoscyamus_muticus	Hyoscyamus_muticus	no
Hyoscyamus_niger	Hyoscyamus_niger	no
Hyoscyamus_pusillus	Hyoscyamus_pusillus	no
Hyoscyamus_turcomanicus	Hyoscyamus_turcomanicus	no
Iochroma_australe	Iochroma_australe	no
Iochroma_calycinum	Iochroma_calycinum	no
Iochroma_cardenasianum	Iochroma_cardenasianum	no
Iochroma_confertiflorum	Iochroma_confertiflorum	no
Iochroma_cornifolium	Iochroma_cornifolium	no
Iochroma_cyaneum	Iochroma_cyaneum	no
Iochroma_edule	Iochroma_edule	no
Iochroma_ellipticum	Iochroma_ellipticum	no
Iochroma_fuchsioides	Iochroma_fuchsioides	no
Iochroma_gesnerioides	Iochroma_gesnerioides	no
Iochroma_grandiflorum	Iochroma_grandiflorum	no
Iochroma_lehmannii	Iochroma_lehmannii	no
Iochroma_loxense	Iochroma_loxense	no
Iochroma_nitidum	Iochroma_nitidum	no
Iochroma_parvifolium	Iochroma_parvifolium	no
Iochroma_salpoanum	Iochroma_salpoanum	no
Iochroma_squamosum	Iochroma_squamosum	no
Iochroma_stenanthum	Iochroma_stenanthum	no
Iochroma_umbellatum	Iochroma_umbellatum	no
Ipomoea	Ipomoea	no
Jaborosa_integrifolia	Jaborosa_integrifolia	no
Jaborosa_sativa	Jaborosa_sativa	no
Jaborosa_squarrosa	Jaborosa_squarrosa	no
Jaltomata_andersonii	Jaltomata_andersonii	no
Jaltomata_antillana	Jaltomata_antillana	no
Jaltomata_aspera	Jaltomata_aspera	no
Jaltomata_auriculata	Jaltomata_auriculata	no
Jaltomata_bernardelloana	Jaltomata_bernardelloana	no
Jaltomata_bicolor	Jaltomata_bicolor	no
Jaltomata_biflora	Jaltomata_biflora	no
Jaltomata_bohsiana	Jaltomata_bohsiana	no
Jaltomata_cajacayensis	Jaltomata_cajacayensis	no
Jaltomata_chihuahuensis	Jaltomata_chihuahuensis	no
Jaltomata_chotanae	Jaltomata_chotanae	no
Jaltomata_contumacensis	Jaltomata_contumacensis	no
Jaltomata_darcyana	Jaltomata_darcyana	no
Jaltomata_dendroidea	Jaltomata_dendroidea	no
Jaltomata_dentata	Jaltomata_dentata	no
Jaltomata_grandiflora	Jaltomata_grandiflora	no
Jaltomata_guillermoguerrae	Jaltomata_guillermoguerrae	no
Jaltomata_herrerae	Jaltomata_herrerae	no
Jaltomata_lanata	Jaltomata_lanata	no
Jaltomata_leivae	Jaltomata_leivae	no
Jaltomata_lezamae	Jaltomata_lezamae	no
Jaltomata_lojae	Jaltomata_lojae	no
Jaltomata_lomana	Jaltomata_lomana	no
Jaltomata_mionei	Jaltomata_mionei	no
Jaltomata_nigricolor	Jaltomata_nigricolor	no
Jaltomata_oppositifolia	Jaltomata_oppositifolia	no
Jaltomata_paneroi	Jaltomata_paneroi	no
Jaltomata_procumbens	Jaltomata_procumbens	no
Jaltomata_repandidentata	Jaltomata_repandidentata	no
Jaltomata_sagastegui	Jaltomata_sagastegui	no
Jaltomata_salpoensis	Jaltomata_salpoensis	no
Jaltomata_sanchezvegae	Jaltomata_sanchezvegae	no
Jaltomata_sinuosa	Jaltomata_sinuosa	no
Jaltomata_tayabambae	Jaltomata_tayabambae	no
Jaltomata_truxillana	Jaltomata_truxillana	no
Jaltomata_umbellata	Jaltomata_umbellata	no
Jaltomata_ventricosa	Jaltomata_ventricosa	no
Jaltomata_viridiflora	Jaltomata_viridiflora	no
Jaltomata_weberbaueri	Jaltomata_weberbaueri	no
Jaltomata_yacheri	Jaltomata_yacheri	no
Jaltomata_yungayensis	Jaltomata_yungayensis	no
Juanulloa_mexicana	Juanulloa_mexicana	no
Larnax_dilloniana	Larnax_dilloniana	no
Larnax_hawkesii	Larnax_hawkesii	no
Larnax_nieva	Larnax_nieva	no
Larnax_parviflora	Larnax_parviflora	no
Larnax_peruviana	Larnax_peruviana	no
Larnax_psilophyta	Larnax_psilophyta	no
Larnax_purpurea	Larnax_purpurea	no
Larnax_sachapapa	Larnax_sachapapa	no
Larnax_subtriflora	Larnax_subtriflora	no
Larnax_suffruticosa	Larnax_suffruticosa	no
Larnax_sylvarum	Larnax_sylvarum	no
Latua_pubiflora	Latua_pubiflora	no
Leptoglossis_darcyana	Leptoglossis_darcyana	no
Leucophysalis_grandiflora	Leucophysalis_grandiflora	no
Leucophysalis_nana	Leucophysalis_nana	no
Leucophysalis_viscosa	Schraderanthus_viscosa	no
Lycianthes_acapulcensis	Lycianthes_acapulcensis	no
Lycianthes_acutifolia	Lycianthes_acutifolia	no
Lycianthes_amatitlanensis	Lycianthes_amatitlanensis	no
Lycianthes_asarifolia	Lycianthes_asarifolia	no
Lycianthes_beckneriana	Lycianthes_beckneriana	no
Lycianthes_biflora	Lycianthes_biflora	no
Lycianthes_ciliolata	Lycianthes_ciliolata	no
Lycianthes_dejecta	Lycianthes_dejecta	no
Lycianthes_denticulata	Lycianthes_denticulata	no
Lycianthes_fasciculata	Lycianthes_fasciculata	no
Lycianthes_furcatistellata	Lycianthes_furcatistellata	no
Lycianthes_geminiflora	Lycianthes_geminiflora	no
Lycianthes_glandulosa	Lycianthes_glandulosa	no
Lycianthes_heteroclita	Lycianthes_heteroclita	no
Lycianthes_inaequilatera	Lycianthes_inaequilatera	no
Lycianthes_jalicensis	Lycianthes_jalicensis	no
Lycianthes_jelskii	Lycianthes_jelskii	no
Lycianthes_lenta	Lycianthes_lenta	no
Lycianthes_lycioides	Lycianthes_lycioides	no
Lycianthes_lysimachioides	Lycianthes_lysimachioides	no
Lycianthes_moziniana	Lycianthes_moziniana	no
Lycianthes_multiflora	Lycianthes_multiflora	no
Lycianthes_nitida	Lycianthes_nitida	no
Lycianthes_peduncularis	Lycianthes_peduncularis	no
Lycianthes_pringlei	Lycianthes_pringlei	no
Lycianthes_pseudolycioides	Lycianthes_pauciflora	no
Lycianthes_radiata	Lycianthes_radiata	no
Lycianthes_rantonnei	Lycianthes_rantonnei	no
Lycianthes_rzedowskii	Lycianthes_rzedowskii	no
Lycianthes_saltensis	Lycianthes_fasciculata	yes
Lycianthes_sanctaeclarae	Lycianthes_sanctaeclarae	no
Lycianthes_shanesii	Lycianthes_shanesii	no
Lycianthes_stephanocalyx	Lycianthes_stephanocalyx	no
Lycianthes_surotatensis	Lycianthes_surotatensis	no
Lycianthes_synanthera	Lycianthes_synanthera	no
Lycianthes_tricolor	Lycianthes_tricolor	no
Lycium_acutifolium	Lycium_acutifolium	no
Lycium_afrum	Lycium_afrum	no
Lycium_ameghinoi	Lycium_ameghinoi	no
Lycium_americanum	Lycium_americanum	no
Lycium_amoenum	Lycium_amoenum	no
Lycium_andersonii	Lycium_andersonii	no
Lycium_arenicola	Lycium_arenicola	no
Lycium_athium	Lycium_athium	no
Lycium_australe	Lycium_australe	no
Lycium_barbarum	Lycium_barbarum	no
Lycium_berlandieri	Lycium_berlandieri	no
Lycium_boerhaviifolium	Lycium_boerhaviifolium	no
Lycium_bosciifolium	Lycium_bosciifolium	no
Lycium_brevipes	Lycium_brevipes	no
Lycium_californicum	Lycium_californicum	no
Lycium_carolinianum	Lycium_carolinianum	no
Lycium_cestroides	Lycium_cestroides	no
Lycium_chanar	Lycium_chanar	no
Lycium_chilense	Lycium_chilense	no
Lycium_chinense	Lycium_chinense	no
Lycium_ciliatum	Lycium_ciliatum	no
Lycium_cinereum	Lycium_cinereum	no
Lycium_cooperi	Lycium_cooperi	no
Lycium_cuneatum	Lycium_cuneatum	no
Lycium_dasystemum	Lycium_dasystemum	no
Lycium_decumbens	Lycium_decumbens	no
Lycium_depressum	Lycium_depressum	no
Lycium_deserti	Lycium_deserti	no
Lycium_duplicatum	Lycium_not_a_name	yes
Lycium_eenii	Lycium_eenii	no
Lycium_elongatum	Lycium_elongatum	no
Lycium_europaeum	Lycium_europaeum	no
Lycium_exsertum	Lycium_exsertum	no
Lycium_ferocissimum	Lycium_ferocissimum	no
Lycium_fremontii	Lycium_fremontii	no
Lycium_fuscum	Lycium_fuscum	no
Lycium_gariepense	Lycium_gariepense	no
Lycium_gilliesianum	Lycium_gilliesianum	no
Lycium_grandicalyx	Lycium_grandicalyx	no
Lycium_hirsutum	Lycium_hirsutum	no
Lycium_horridum	Lycium_horridum	no
Lycium_infaustum	Lycium_infaustum	no
Lycium_macrodon	Lycium_macrodon	no
Lycium_microphyllum	Lycium_microphyllum	no
Lycium_minimum	Lycium_minimum	no
Lycium_minutifolium	Lycium_minutifolium	no
Lycium_morongii	Lycium_morongii	no
Lycium_nodosum	Lycium_nodosum	no
Lycium_oxycarpum	Lycium_oxycarpum	no
Lycium_pallidum	Lycium_pallidum	no
Lycium_parishii	Lycium_parishii	no
Lycium_pilifolium	Lycium_pilifolium	no
Lycium_puberulum	Lycium_puberulum	no
Lycium_pumilum	Lycium_pumilum	no
Lycium_rachidocladum	Lycium_rachidocladum	no
Lycium_ruthenicum	Lycium_ruthenicum	no
Lycium_sandwicense	Lycium_carolinianum	yes
Lycium_schizocalyx	Lycium_schizocalyx	no
Lycium_schweinfurthii	Lycium_schweinfurthii	no
Lycium_shawii	Lycium_shawii	no
Lycium_shockleyi	Lycium_shockleyi	no
Lycium_stenophyllum	Lycium_stenophyllum	no
Lycium_strandveldense	Lycium_strandveldense	no
Lycium_tenue	Lycium_tenue	no
Lycium_tenuispinosum	Lycium_tenuispinosum	no
Lycium_tetrandrum	Lycium_tetrandrum	no
Lycium_texanum	Lycium_texanum	no
Lycium_torreyi	Lycium_torreyi	no
Lycium_truncatum	Lycium_truncatum	no
Lycium_villosum	Lycium_villosum	no
Lycium_vimineum	Lycium_vimineum	no
Lycium_yunnanense	Lycium_yunnanense	no
Mandragora_autumnalis	Mandragora_officinarum	yes
Mandragora_caulescens	Mandragora_caulescens	no
Mandragora_chinghaiensis	Mandragora_caulescens	yes
Mandragora_officinarum	Mandragora_officinarum	no
Mandragora_turcomanica	Mandragora_turcomanica	no
Markea_panamensis	Markea_panamensis	no
Markea_ulei	Markea_ulei	no
Melananthus_guatemalensis	Melananthus_guatemalensis	no
Mellissia_begoniifolia	Mellissia_begoniifolia	no
Merinthopodium_neuranthum	Merinthopodium_neuranthum	no
Metternichia_princeps	Metternichia_princeps	no
Metternichia_sp	Metternichia_sp	no
Nectouxia_formosa	Nectouxia_formosa	no
Nicandra_physalodes	Nicandra_physalodes	no
Nicotiana_acaulis	Nicotiana_acaulis	no
Nicotiana_acuminata	Nicotiana_acuminata	no
Nicotiana_africana	Nicotiana_africana	no
Nicotiana_alata	Nicotiana_alata	no
Nicotiana_amplexicaulis	Nicotiana_amplexicaulis	no
Nicotiana_arentsii	Nicotiana_arentsii	no
Nicotiana_benavidesii	Nicotiana_benavidesii	no
Nicotiana_bonariensis	Nicotiana_bonariensis	no
Nicotiana_cavicola	Nicotiana_cavicola	no
Nicotiana_clevelandii	Nicotiana_clevelandii	no
Nicotiana_cordifolia	Nicotiana_cordifolia	no
Nicotiana_corymbosa	Nicotiana_corymbosa	no
Nicotiana_digluta	Nicotiana_digluta	no
Nicotiana_eastii	Nicotiana_eastii	no
Nicotiana_excelsior	Nicotiana_excelsior	no
Nicotiana_exigua	Nicotiana_rotundifolia	yes
Nicotiana_forgetiana	Nicotiana_forgetiana	no
Nicotiana_forsteri	Nicotiana_forsteri	no
Nicotiana_glauca	Nicotiana_glauca	no
Nicotiana_glutinosa	Nicotiana_glutinosa	no
Nicotiana_goodspeedii	Nicotiana_goodspeedii	no
Nicotiana_gossei	Nicotiana_gossei	no
Nicotiana_kawakamii	Nicotiana_kawakamii	no
Nicotiana_knightiana	Nicotiana_knightiana	no
Nicotiana_langsdorffii	Nicotiana_langsdorffii	no
Nicotiana_linearis	Nicotiana_linearis	no
Nicotiana_longiflora	Nicotiana_longiflora	no
Nicotiana_maritima	Nicotiana_maritima	no
Nicotiana_megalosiphon	Nicotiana_megalosiphon	no
Nicotiana_miersii	Nicotiana_miersii	no
Nicotiana_nesophila	Nicotiana_nesophila	no
Nicotiana_noctiflora	Nicotiana_noctiflora	no
Nicotiana_nudicaulis	Nicotiana_nudicaulis	no
Nicotiana_obtusifolia	Nicotiana_obtusifolia	no
Nicotiana_occidentalis	Nicotiana_occidentalis	no
Nicotiana_otophora	Nicotiana_otophora	no
Nicotiana_palmeri	Nicotiana_obtusifolia	yes
Nicotiana_paniculata	Nicotiana_paniculata	no
Nicotiana_pauciflora	Nicotiana_pauciflora	no
Nicotiana_petunioides	Nicotiana_petunioides	no
Nicotiana_picilla	Nicotiana_plumbaginifolia	yes
Nicotiana_plumbaginifolia	Nicotiana_plumbaginifolia	no
Nicotiana_quadrivalvis	Nicotiana_quadrivalvis	no
Nicotiana_raimondii	Nicotiana_raimondii	no
Nicotiana_repanda	Nicotiana_repanda	no
Nicotiana_rosulata	Nicotiana_rosulata	no
Nicotiana_rotundifolia	Nicotiana_rotundifolia	no
Nicotiana_rustica	Nicotiana_rustica	no
Nicotiana_simulans	Nicotiana_simulans	no
Nicotiana_solanifolia	Nicotiana_solanifolia	no
Nicotiana_spegazzinii	Nicotiana_spegazzinii	no
Nicotiana_stocktonii	Nicotiana_stocktonii	no
Nicotiana_suaveolens	Nicotiana_suaveolens	no
Nicotiana_sylvestris	Nicotiana_sylvestris	no
Nicotiana_tabacum	Nicotiana_tabacum	no
Nicotiana_thyrsiflora	Nicotiana_thyrsiflora	no
Nicotiana_tomentosa	Nicotiana_tomentosa	no
Nicotiana_tomentosiformis	Nicotiana_tomentosiformis	no
Nicotiana_trigonophylla	Nicotiana_obtusifolia	yes
Nicotiana_umbratica	Nicotiana_umbratica	no
Nicotiana_undulata	Nicotiana_undulata	no
Nicotiana_velutina	Nicotiana_velutina	no
Nicotiana_wigandioides	Nicotiana_wigandioides	no
Nierembergia_andina	Nierembergia_pulchella	yes
Nierembergia_angustifolia	Nierembergia_angustifolia	no
Nierembergia_aristata	Nierembergia_aristata	no
Nierembergia_boliviana	Nierembergia_pulchella	yes
Nierembergia_browallioides	Nierembergia_browallioides	no
Nierembergia_calycina	Nierembergia_calycina	no
Nierembergia_ericoides	Nierembergia_ericoides	no
Nierembergia_graveolens	Nierembergia_graveolens	no
Nierembergia_hatschbachii	Nierembergia_hatschbachii	no
Nierembergia_hippomanica	Nierembergia_linariifolia	yes
Nierembergia_linariifolia	Nierembergia_linariifolia	no
Nierembergia_micrantha	Nierembergia_micrantha	no
Nierembergia_pinifolia	Nierembergia_pinifolia	no
Nierembergia_pulchella	Nierembergia_pulchella	no
Nierembergia_repens	Nierembergia_repens	no
Nierembergia_rigida	Nierembergia_rigida	no
Nierembergia_rivularis	Nierembergia_rivularis	no
Nierembergia_scoparia	Nierembergia_scoparia	no
Nierembergia_spathulata	Nierembergia_spathulata	no
Nierembergia_tucumanensis	Nierembergia_tucumanensis	no
Nierembergia_veitchii	Nierembergia_veitchii	no
Nolana_acuminata	Nolana_acuminata	no
Nolana_adansonii	Nolana_adansonii	no
Nolana_albescens	Nolana_albescens	no
Nolana_aplocaryoides	Nolana_aplocaryoides	no
Nolana_arequipensis	Nolana_arequipensis	no
Nolana_aticoana	Nolana_aticoana	no
Nolana_baccata	Nolana_baccata	no
Nolana_balsamiflua	Nolana_balsamiflua	no
Nolana_carnosa	Nolana_carnosa	no
Nolana_cerrateana	Nolana_cerrateana	no
Nolana_chancoana	Nolana_chancoana	no
Nolana_chapiensis	Nolana_chapiensis	no
Nolana_clivicola	Nolana_clivicola	no
Nolana_coelestis	Nolana_coelestis	no
Nolana_confinis	Nolana_confinis	no
Nolana_coronata	Nolana_coronata	no
Nolana_crassulifolia	Nolana_crassulifolia	no
Nolana_diffusa	Nolana_diffusa	no
Nolana_divaricata	Nolana_divaricata	no
Nolana_elegans	Nolana_elegans	no
Nolana_filifolia	Nolana_filifolia	no
Nolana_flaccida	Nolana_flaccida	no
Nolana_galapagensis	Nolana_galapagensis	no
Nolana_gayana	Nolana_gayana	no
Nolana_humifusa	Nolana_humifusa	no
Nolana_incana	Nolana_incana	no
Nolana_inflata	Nolana_inflata	no
Nolana_intonsa	Nolana_intonsa	no
Nolana_johnstonii	Nolana_johnstonii	no
Nolana_laxa	Nolana_laxa	no
Nolana_leptophylla	Nolana_leptophylla	no
Nolana_lezamae	Nolana_lezamae	no
Nolana_linearifolia	Nolana_linearifolia	no
Nolana_lycioides	Nolana_lycioides	no
Nolana_mollis	Nolana_mollis	no
Nolana_onoana	Nolana_onoana	no
Nolana_pallida	Nolana_pallida	no
Nolana_paradoxa	Nolana_paradoxa	no
Nolana_parviflora	Nolana_parviflora	no
Nolana_peruviana	Nolana_peruviana	no
Nolana_pilosa	Nolana_pilosa	no
Nolana_plicata	Nolana_plicata	no
Nolana_pterocarpa	Nolana_pterocarpa	no
Nolana_ramosissima	Nolana_ramosissima	no
Nolana_rostrata	Nolana_rostrata	no
Nolana_rupicola	Nolana_rupicola	no
Nolana_salsoloides	Nolana_salsoloides	no
Nolana_scaposa	Nolana_scaposa	no
Nolana_sedifolia	Nolana_sedifolia	no
Nolana_sessiliflora	Nolana_sessiliflora	no
Nolana_spathulata	Nolana_spathulata	no
Nolana_sphaerophylla	Nolana_sphaerophylla	no
Nolana_stenophylla	Nolana_stenophylla	no
Nolana_tarapacana	Nolana_tarapacana	no
Nolana_thinophila	Nolana_thinophila	no
Nolana_tocopillensis	Nolana_tocopillensis	no
Nolana_tomentella	Nolana_tomentella	no
Nolana_urubambae	Nolana_urubambae	no
Nolana_villosa	Nolana_villosa	no
Nolana_volcanica	Nolana_volcanica	no
Nolana_weissiana	Nolana_weissiana	no
Nolana_werdermannii	Nolana_werdermannii	no
Nolana_willeana	Nolana_willeana	no
Nothocestrum_latifolium	Nothocestrum_latifolium	no
Nothocestrum_longifolium	Nothocestrum_longifolium	no
Oryctes_nevadensis	Oryctes_nevadensis	no
Pantacantha_ameghinoi	Pantacantha_ameghinoi	no
Petunia_altiplana	Petunia_altiplana	no
Petunia_axillaris	Petunia_axillaris	no
Petunia_bonjardinensis	Petunia_bonjardinensis	no
Petunia_exserta	Petunia_exserta	no
Petunia_integrifolia	Petunia_integrifolia	no
Petunia_littoralis	Petunia_integrifolia	yes
Petunia_mantiqueirensis	Petunia_mantiqueirensis	no
Petunia_reitzii	Petunia_reitzii	no
Petunia_saxicola	Petunia_saxicola	no
Petunia_scheideana	Petunia_scheideana	no
Petunia_secreta	Petunia_secreta	no
Physalis_acutifolia	Physalis_acutifolia	no
Physalis_alkekengi	Physalis_alkekengi	no
Physalis_angulata	Physalis_angulata	no
Physalis_angustifolia	Physalis_angustifolia	no
Physalis_angustiphysa	Physalis_angustiphysa	no
Physalis_arborescens	Physalis_campechiana	no
Physalis_arenicola	Physalis_arenicola	no
Physalis_campanulata	Physalis_campanulata	no
Physalis_carpenteri	Physalis_carpenteri	no
Physalis_caudella	Physalis_caudella	no
Physalis_cinerascens	Physalis_cinerascens	no
Physalis_cordata	Physalis_cordata	no
Physalis_coztomatl	Physalis_coztomatl	no
Physalis_crassifolia	Physalis_crassifolia	no
Physalis_glutinosa	Physalis_glutinosa	no
Physalis_greenmanii	Physalis_greenmanii	no
Physalis_hederifolia	Physalis_hederifolia	no
Physalis_heterophylla	Physalis_heterophylla	no
Physalis_ignota	Physalis_ignota	no
Physalis_lagascae	Physalis_lagascae	no
Physalis_lanceolata	Physalis_lanceolata	no
Physalis_lassa	Physalis_lassa	no
Physalis_longifolia	Physalis_longifolia	no
Physalis_melanocystis	Physalis_melanocystis	no
Physalis_microcarpa	Physalis_microcarpa	no
Physalis_microphysa	Physalis_microphysa	no
Physalis_minima	Physalis_minima	no
Physalis_minimaculata	Physalis_minimaculata	no
Physalis_mollis	Physalis_mollis	no
Physalis_nicandroides	Physalis_nicandroides	no
Physalis_patula	Physalis_patula	no
Physalis_peruviana	Physalis_peruviana	no
Physalis_philadelphica	Physalis_philadelphica	no
Physalis_pruinosa	Physalis_pruinosa	no
Physalis_pubescens	Physalis_pubescens	no
Physalis_pumila	Physalis_pumila	no
Physalis_sordida	Physalis_sordida	no
Physalis_virginiana	Physalis_virginiana	no
Physalis_viscosa	Physalis_viscosa	no
Physalis_walteri	Physalis_walteri	no
Physochlaina_infundibularis	Physochlaina_infundibularis	no
Physochlaina_orientalis	Physochlaina_orientalis	no
Physochlaina_physaloides	Physochlaina_physaloides	no
Physochlaina_praealta	Physochlaina_praealta	no
Plowmania_nyctaginoides	Plowmania_nyctaginoides	no
Protoschwenkia_mandonii	Protoschwenkia_mandonii	no
Przewalskia_tangutica	Przewalskia_tangutica	no
Quincula_lobata	Quincula_lobata	no
Reyesia_sp	Reyesia_sp	no
Salpichroa_origanifolia	Salpichroa_origanifolia	no
Salpiglossis_sinuata	Salpiglossis_sinuata	no
Saracha_punctata	Saracha_punctata	no
Saracha_quitensis	Saracha_quitensis	no
Schizanthus_alpestris	Schizanthus_alpestris	no
Schizanthus_candidus	Schizanthus_candidus	no
Schizanthus_grahamii	Schizanthus_grahamii	no
Schizanthus_hookeri	Schizanthus_hookeri	no
Schizanthus_integrifolius	Schizanthus_integrifolius	no
Schizanthus_lacteus	Schizanthus_lacteus	no
Schizanthus_laetus	Schizanthus_laetus	no
Schizanthus_litoralis	Schizanthus_litoralis	no
Schizanthus_parvulus	Schizanthus_parvulus	no
Schizanthus_pinnatus	Schizanthus_pinnatus	no
Schizanthus_porrigens	Schizanthus_porrigens	no
Schizanthus_tricolor	Schizanthus_tricolor	no
Schultesianthus_leucanthus	Schultesianthus_leucanthus	no
Schultesianthus_megalandrus	Schultesianthus_megalandrus	no
Schwenckia_glabrata	Schwenckia_glabrata	no
Schwenckia_lateriflora	Schwenckia_lateriflora	no
Sclerophylax_adnatifolia	Sclerophylax_adnatifolia	no
Sclerophylax_gilliesii	Sclerophylax_arnottii	no
Sclerophylax_sp	Sclerophylax_sp	no
Sclerophylax_spinescens	Sclerophylax_spinescens	no
Scopolia_carniolica	Scopolia_carniolica	no
Scopolia_japonica	Scopolia_japonica	no
Scopolia_lutescens	Scopolia_lutescens	no
Scopolia_parviflora	Scopolia_parviflora	no
Sessea_corymbiflora	Sessea_corymbiflora	no
Sessea_stipulata	Sessea_stipulata	no
Sessea_vestita	Sessea_vestita	no
Solandra_brachycalyx	Solandra_brachycalyx	no
Solandra_grandiflora	Solandra_grandiflora	no
Solanum_absconditum	Solanum_absconditum	no
Solanum_abutiloides	Solanum_abutiloides	no
Solanum_acanthodapis	Solanum_acanthodapis	no
Solanum_acaule	Solanum_acaule	no
Solanum_accrescens	Solanum_accrescens	no
Solanum_acerifolium	Solanum_acerifolium	no
Solanum_achacachense	Solanum_candolleanum	yes
Solanum_acroscopicum	Solanum_acroscopicum	no
Solanum_aculeastrum	Solanum_aculeastrum	no
Solanum_aculeatissimum	Solanum_aculeatissimum	no
Solanum_acutilobum	Solanum_acutilobum	no
Solanum_adhaerens	Solanum_volubile	no
Solanum_adscendens	Solanum_adscendens	no
Solanum_aethiopicum	Solanum_aethiopicum	no
Solanum_aggregatum	Solanum_guineense	yes
Solanum_agrarium	Solanum_agrarium	no
Solanum_agrimonifolium	Solanum_agrimoniifolium	no
Solanum_alandiae	Solanum_brevicaule	yes
Solanum_albicans	Solanum_albicans	no
Solanum_albidum	Solanum_albidum	no
Solanum_aligerum	Solanum_aligerum	no
Solanum_allophyllum	Solanum_allophyllum	no
Solanum_amblymerum	Solanum_amblymerum	no
Solanum_americanum	Solanum_americanum	no
Solanum_amygdalifolium	Solanum_amygdalifolium	no
Solanum_anceps	Solanum_anceps	no
Solanum_andreanum	Solanum_andreanum	no
Solanum_anguivi	Solanum_anguivi	no
Solanum_angustialatum	Solanum_angustialatum	no
Solanum_angustifolium	Solanum_angustifolium	no
Solanum_annuum	Solanum_annuum	no
Solanum_aphyodendron	Solanum_aphyodendron	no
Solanum_appendiculatum	Solanum_appendiculatum	no
Solanum_arachnidanthum	Solanum_arachnidanthum	no
Solanum_arboreum	Solanum_arboreum	no
Solanum_argentinum	Solanum_argentinum	no
Solanum_argopetalum	Solanum_argopetalum	no
Solanum_arnezii	Solanum_chacoense	yes
Solanum_arundo	Solanum_arundo	no
Solanum_asperolanatum	Solanum_asperolanatum	no
Solanum_asperum	Solanum_asperum	no
Solanum_asterophorum	Solanum_asterophorum	no
Solanum_asteropilodes	Solanum_asteropilodes	no
Solanum_asymmetriphyllum	Solanum_asymmetriphyllum	no
Solanum_atropurpureum	Solanum_atropurpureum	no
Solanum_aturense	Solanum_aturense	no
Solanum_aviculare	Solanum_aviculare	no
Solanum_avilesii	Solanum_brevicaule	yes
Solanum_bahamense	Solanum_bahamense	no
Solanum_batoides	Solanum_batoides	no
Solanum_beaugleholei	Solanum_beaugleholei	no
Solanum_berthaultii	Solanum_berthaultii	no
Solanum_betaceum	Solanum_betaceum	no
Solanum_bicorne	Solanum_bicorne	no
Solanum_bolivianum	Solanum_bolivianum	no
Solanum_bonariense	Solanum_bonariense	no
Solanum_brevicaule	Solanum_brevicaule	no
Solanum_brevifolium	Solanum_brevifolium	no
Solanum_brownii	Solanum_brownii	no
Solanum_buddleifolium	Solanum_buddleifolium	no
Solanum_bukasovii	Solanum_candolleanum	yes
Solanum_bulbocastanum	Solanum_bulbocastanum	no
Solanum_bumeliifolium	Solanum_bumeliifolium	no
Solanum_cacosmum	Solanum_cacosmum	no
Solanum_caesium	Solanum_caesium	no
Solanum_cajanumense	Solanum_cajanumense	no
Solanum_calileguae	Solanum_calileguae	no
Solanum_campanulatum	Solanum_campanulatum	no
Solanum_campylacanthum	Solanum_campylacanthum	no
Solanum_candidum	Solanum_candidum	no
Solanum_candolleanum	Solanum_candolleanum	no
Solanum_capense	Solanum_capense	no
Solanum_capsicastrum	Solanum_pseudocapsicum	yes
Solanum_capsiciforme	Solanum_capsiciforme	no
Solanum_capsicoides	Solanum_capsicoides	no
Solanum_cardiophyllum	Solanum_cardiophyllum	no
Solanum_carduiforme	Solanum_carduiforme	no
Solanum_caricifolium	Solanum_caricaefolium	no
Solanum_caripense	Solanum_caripense	no
Solanum_carolinense	Solanum_carolinense	no
Solanum_cataphractum	Solanum_cataphractum	no
Solanum_centrale	Solanum_centrale	no
Solanum_cerasiferum	Solanum_cerasiferum	no
Solanum_chacoense	Solanum_chacoense	no
Solanum_chamaepolybotryon	Solanum_chamaepolybotryon	no
Solanum_cheesmaniae	Solanum_cheesmaniae	no
Solanum_chenopodinum	Solanum_chenopodinum	no
Solanum_chenopodium	Solanum_chenopodinum	yes
Solanum_chilense	Solanum_chilense	no
Solanum_chippendalei	Solanum_chippendalei	no
Solanum_chmielewskii	Solanum_chmielewskii	no
Solanum_chomatophilum	Solanum_chomatophilum	no
Solanum_chrysotrichum	Solanum_chrysotrichum	no
Solanum_cinereum	Solanum_cinereum	no
Solanum_circaeifolium	Solanum_stipuloideum	no
Solanum_circinatum	Solanum_splendens	no
Solanum_citrullifolium	Solanum_citrullifolium	no
Solanum_clandestinum	Solanum_clandestinum	no
Solanum_clarkiae	Solanum_clarkiae	no
Solanum_clarum	Solanum_clarum	no
Solanum_cleistogamum	Solanum_cleistogamum	no
Solanum_coactiliferum	Solanum_coactiliferum	no
Solanum_colombianum	Solanum_colombianum	no
Solanum_comarapanum	Solanum_comarapanum	no
Solanum_comptum	Solanum_comptum	no
Solanum_conditum	Solanum_aridum	no
Solanum_confusum	Solanum_confusum	no
Solanum_conicum	Solanum_conicum	no
Solanum_cookii	Solanum_cookii	no
Solanum_cordovense	Solanum_cordovense	no
Solanum_coriaceum	Solanum_coriaceum	no
Solanum_corifolium	Solanum_corifolium	no
Solanum_crinitipes	Solanum_crinitipes	no
Solanum_crinitum	Solanum_crinitum	no
Solanum_crispum	Solanum_crispum	no
Solanum_crotonoides	Solanum_crotonoides	no
Solanum_cumingii	Solanum_insanum	no
Solanum_cunninghamii	Solanum_cunninghamii	no
Solanum_curvicuspe	Solanum_curvicuspe	no
Solanum_cyaneopurpureum	Solanum_cyaneopurpureum	no
Solanum_cylindricum	Solanum_cylindricum	no
Solanum_dasyphyllum	Solanum_dasyphyllum	no
Solanum_davisense	Solanum_davisense	no
Solanum_decompositiflorum	Solanum_decompositiflorum	no
Solanum_delitescens	Solanum_delitescens	no
Solanum_demissum	Solanum_demissum	no
Solanum_densevestitum	Solanum_densevestitum	no
Solanum_dianthophorum	Solanum_ellipticum	yes
Solanum_dimorphispinum	Solanum_dimorphispinum	no
Solanum_dioicum	Solanum_dioicum	no
Solanum_diphyllum	Solanum_diphyllum	no
Solanum_diploconos	Solanum_diploconos	no
Solanum_discolor	Solanum_discolor	no
Solanum_dissectum	Solanum_dissectum	no
Solanum_ditrichum	Solanum_ditrichum	no
Solanum_diversiflorum	Solanum_diversiflorum	no
Solanum_doddsii	Solanum_doddsii	no
Solanum_donianum	Solanum_donianum	no
Solanum_drymophilum	Solanum_ensifolium	no
Solanum_dulcamara	Solanum_dulcamara	no
Solanum_echinatum	Solanum_echinatum	no
Solanum_ehrenbergii	Solanum_ehrenbergii	no
Solanum_elachophyllum	Solanum_elachophyllum	no
Solanum_elaeagnifolium	Solanum_elaeagnifolium	no
Solanum_ellipticum	Solanum_ellipticum	no
Solanum_enantiophyllanthum	Solanum_enantiophyllanthum	no
Solanum_endopogon	Solanum_endopogon	no
Solanum_esuriale	Solanum_esuriale	no
Solanum_etuberosum	Solanum_etuberosum	no
Solanum_evolvulifolium	Solanum_evolvulifolium	no
Solanum_exiguum	Solanum_exiguum	no
Solanum_fallax	Solanum_fallax	no
Solanum_felinum	Solanum_felinum	no
Solanum_ferocissimum	Solanum_ferocissimum	no
Solanum_fiebrigii	Solanum_fiebrigii	no
Solanum_fraxinifolium	Solanum_fraxinifolium	no
Solanum_fructotecto	Solanum_fructu-tecto	no
Solanum_furfuraceum	Solanum_furfuraceum	no
Solanum_fusiforme	Solanum_fusiforme	no
Solanum_gabrielae	Solanum_gabrielae	no
Solanum_galapagense	Solanum_galapagense	no
Solanum_gardneri	Solanum_gardneri	no
Solanum_giganteum	Solanum_giganteum	no
Solanum_glabratum	Solanum_glabratum	no
Solanum_glaucophyllum	Solanum_glaucophyllum	no
Solanum_glutinosum	Solanum_glutinosum	no
Solanum_goetzei	Solanum_goetzei	no
Solanum_grayi	Solanum_grayi	no
Solanum_guerreroense	Solanum_guerreroense	no
Solanum_guineense	Solanum_guineense	no
Solanum_gympiense	Solanum_gympiense	no
Solanum_habrochaites	Solanum_habrochaites	no
Solanum_hapalum	Solanum_hapalum	no
Solanum_hasslerianum	Solanum_hasslerianum	no
Solanum_havanense	Solanum_havanense	no
Solanum_hayesii	Solanum_hayesii	no
Solanum_heinianum	Solanum_heinianum	no
Solanum_herculeum	Solanum_herculeum	no
Solanum_heterodoxum	Solanum_heterodoxum	no
Solanum_heteropodium	Solanum_heteropodium	no
Solanum_hexandrum	Solanum_hexandrum	no
Solanum_hibernum	Solanum_hibernum	no
Solanum_hieronymi	Solanum_hieronymi	no
Solanum_hindsianum	Solanum_hindsianum	no
Solanum_hirtum	Solanum_hirtum	no
Solanum_hjertingii	Solanum_hjertingii	no
Solanum_hoehnei	Solanum_hoehnei	no
Solanum_hoplopetalum	Solanum_hoplopetalum	no
Solanum_horridum	Solanum_horridum	no
Solanum_hougasii	Solanum_hougasii	no
Solanum_humile	Solanum_humile	no
Solanum_hyporhodium	Solanum_hyporhodium	no
Solanum_hystrix	Solanum_hystrix	no
Solanum_immite	Solanum_immite	no
Solanum_inaequilaterum	Solanum_inaequilaterum	no
Solanum_incamayoense	Solanum_brevicaule	yes
Solanum_incanum	Solanum_incanum	no
Solanum_incarceratum	Solanum_incarceratum	no
Solanum_incompletum	Solanum_incompletum	no
Solanum_incurvum	Solanum_incurvum	no
Solanum_inelegans	Solanum_inelegans	no
Solanum_infundibuliforme	Solanum_infundibuliforme	no
Solanum_innoxium	Solanum_innoxium	no
Solanum_iopetalum	Solanum_iopetalum	no
Solanum_jabrense	Solanum_jabrense	no
Solanum_jamaicense	Solanum_jamaicense	no
Solanum_jamesii	Solanum_jamesii	no
Solanum_johnsonianum	Solanum_johnsonianum	no
Solanum_johnstonii	Solanum_johnstonii	no
Solanum_jucundum	Solanum_jucundum	no
Solanum_juglandifolium	Solanum_juglandifolium	no
Solanum_juvenale	Solanum_juvenale	no
Solanum_kurtzianum	Solanum_kurtzianum	no
Solanum_kurzii	Solanum_violaceum	yes
Solanum_kwebense	Solanum_tettense	no
Solanum_laciniatum	Solanum_laciniatum	no
Solanum_lamprocarpum	Solanum_lamprocarpum	no
Solanum_lanceifolium	Solanum_lanceifolium	no
Solanum_lanceolatum	Solanum_lanceolatum	no
Solanum_lasiocarpum	Solanum_lasiocarpum	no
Solanum_lasiophyllum	Solanum_lasiophyllum	no
Solanum_latens	Solanum_latens	no
Solanum_latiflorum	Solanum_latiflorum	no
Solanum_laxissimum	Solanum_laxissimum	no
Solanum_laxum	Solanum_laxum	no
Solanum_leopoldense	Solanum_leopoldensis	no
Solanum_lepidotum	Solanum_lepidotum	no
Solanum_leptophyes	Solanum_brevicaule	yes
Solanum_lichtensteinii	Solanum_lichtensteinii	no
Solanum_lidii	Solanum_lidii	no
Solanum_lignicaule	Solanum_lignicaule	no
Solanum_limitare	Solanum_limitare	no
Solanum_linearifolium	Solanum_linearifolium	no
Solanum_linnaeanum	Solanum_linnaeanum	no
Solanum_longiconicum	Solanum_longiconicum	no
Solanum_lucani	Solanum_lucani	no
Solanum_lumholtzianum	Solanum_lumholtzianum	no
Solanum_luteoalbum	Solanum_luteoalbum	no
Solanum_lycocarpum	Solanum_lycocarpum	no
Solanum_lycopersicoides	Solanum_lycopersicoides	no
Solanum_lycopersicum	Solanum_lycopersicum	no
Solanum_lyratum	Solanum_lyratum	no
Solanum_lythrocarpum	Solanum_lythrocarpum	no
Solanum_macoorai	Solanum_macoorai	no
Solanum_macrocarpon	Solanum_macrocarpon	no
Solanum_maglia	Solanum_maglia	no
Solanum_mahoriense	Solanum_mahoriense	no
Solanum_mammosum	Solanum_mammosum	no
Solanum_mapiriense	Solanum_mapiriense	no
Solanum_marginatum	Solanum_marginatum	no
Solanum_marinasense	Solanum_candolleanum	yes
Solanum_maternum	Solanum_maternum	no
Solanum_mauritianum	Solanum_mauritianum	no
Solanum_megalonyx	Solanum_megalonyx	no
Solanum_megistacrolobum	Solanum_boliviense	no
Solanum_melanospermum	Solanum_melanospermum	no
Solanum_melissarum	Solanum_melissarum	no
Solanum_melongena	Solanum_melongena	no
Solanum_microdontum	Solanum_microdontum	no
Solanum_microphyllum	Solanum_microphyllum	no
Solanum_mitchellianum	Solanum_mitchellianum	no
Solanum_mite	Solanum_mite	no
Solanum_mitlense	Solanum_mitlense	no
Solanum_monachophyllum	Solanum_monachophyllum	no
Solanum_monarchostemon	Solanum_monarchostemon	no
Solanum_montanum	Solanum_montanum	no
Solanum_morelliforme	Solanum_morelliforme	no
Solanum_mortonii	Solanum_mortonii	no
Solanum_moscopanum	Solanum_colombianum	yes
Solanum_moxosense	Solanum_moxosense	no
Solanum_multifidum	Solanum_multifidum	no
Solanum_multiinterruptum	Solanum_multiinterruptum	no
Solanum_multispinum	Solanum_multispinum	no
Solanum_multivenosum	Solanum_multivenosum	no
Solanum_muricatum	Solanum_muricatum	no
Solanum_myoxotrichum	Solanum_myoxotrichum	no
Solanum_myriacanthum	Solanum_myriacanthum	no
Solanum_nakurense	Solanum_terminale	yes
Solanum_nemophilum	Solanum_nemophilum	no
Solanum_nemorense	Solanum_nemorense	no
Solanum_neoanglicum	Solanum_neoanglicum	no
Solanum_neorickii	Solanum_neorickii	no
Solanum_nigriviolaceum	Solanum_nigriviolaceum	no
Solanum_nigrum	Solanum_nigrum	no
Solanum_nitidum	Solanum_nitidum	no
Solanum_nobile	Solanum_nobile	no
Solanum_nummularium	Solanum_nummularium	no
Solanum_obliquum	Solanum_obliquum	no
Solanum_occultum	Solanum_occultum	no
Solanum_ochranthum	Solanum_ochranthum	no
Solanum_ochrophyllum	Solanum_ochrophyllum	no
Solanum_oedipus	Solanum_oedipus	no
Solanum_okadae	Solanum_okadae	no
Solanum_oldfieldii	Solanum_oldfieldii	no
Solanum_oligacanthum	Solanum_oligacanthum	no
Solanum_opacum	Solanum_opacum	no
Solanum_oplocense	Solanum_brevicaule	yes
Solanum_orbiculatum	Solanum_orbiculatum	no
Solanum_ovigerum	Solanum_melongena	yes
Solanum_oxycarpum	Solanum_oxycarpum	no
Solanum_oxyphyllum	Solanum_oxyphyllum	no
Solanum_palinacanthum	Solanum_palinacanthum	no
Solanum_palitans	Solanum_palitans	no
Solanum_pallidum	Solanum_pallidum	no
Solanum_paludosum	Solanum_paludosum	no
Solanum_palustre	Solanum_palustre	no
Solanum_pampasense	Solanum_candolleanum	yes
Solanum_pancheri	Solanum_pancheri	no
Solanum_panduriforme	Solanum_campylacanthum 	yes
Solanum_paniculatum	Solanum_paniculatum	no
Solanum_papaverifolium	Solanum_papaverifolium	no
Solanum_paposanum	Solanum_paposanum	no
Solanum_paraibanum	Solanum_paraibanum	no
Solanum_pascoense	Solanum_chomatophilum	yes
Solanum_pectinatum	Solanum_pectinatum	no
Solanum_pedemontanum	Solanum_pedemontanum	no
Solanum_pendulum	Solanum_pendulum	no
Solanum_pennellii	Solanum_pennellii	no
Solanum_peruvianum	Solanum_peruvianum	no
Solanum_petraeum	Solanum_petraeum	no
Solanum_petrophilum	Solanum_petrophilum	no
Solanum_phaseoloides	Solanum_phaseoloides	no
Solanum_phlomoides	Solanum_phlomoides	no
Solanum_physalifolium	Solanum_physalifolium	no
Solanum_pimpinellifolium	Solanum_pimpinellifolium	no
Solanum_pinetorum	Solanum_pinetorum	no
Solanum_pinnatisectum	Solanum_pinnatisectum	no
Solanum_piurae	Solanum_piurae	no
Solanum_platense	Solanum_platense	no
Solanum_pluviale	Solanum_pluviale	no
Solanum_poinsettiifolium	Solanum_poinsettiifolium	no
Solanum_polyadenium	Solanum_polyadenium	no
Solanum_polytrichum	Solanum_polytrichum	no
Solanum_prinophyllum	Solanum_prinophyllum	no
Solanum_proteanthum	Solanum_proteanthum	no
Solanum_pseudocapsicum	Solanum_pseudocapsicum	no
Solanum_pseudolulo	Solanum_pseudolulo	no
Solanum_ptychanthum	Solanum_emulans	no
Solanum_pubigerum	Solanum_pubigerum	no
Solanum_pungetium	Solanum_pungetium	no
Solanum_pyracanthos	Solanum_pyracanthos	no
Solanum_quadrangulare	Solanum_africanum	no
Solanum_quadriloculatum	Solanum_quadriloculatum	no
Solanum_quitoense	Solanum_quitoense	no
Solanum_raphanifolium	Solanum_raphanifolium	no
Solanum_reductum	Solanum_reductum	no
Solanum_reflexiflorum	Solanum_reflexiflorum	no
Solanum_refractum	Solanum_refractum	no
Solanum_repandum	Solanum_repandum	no
Solanum_reptans	Solanum_reptans	no
Solanum_retroflexum	Solanum_retroflexum	no
Solanum_rhytidoandrum	Solanum_rhytidoandrum	no
Solanum_rigescentoides	Solanum_humile	yes
Solanum_riojense	Solanum_riojense	no
Solanum_rixosum	Solanum_rixosum	no
Solanum_robustum	Solanum_robustum	no
Solanum_roseum	Solanum_roseum	no
Solanum_rostratum	Solanum_rostratum	no
Solanum_rovirosanum	Solanum_rovirosanum	no
Solanum_rudepannum	Solanum_rudepannum	no
Solanum_rugosum	Solanum_rugosum	no
Solanum_rupincola	Solanum_rupincola	no
Solanum_sandwicense	Solanum_sandwicense	no
Solanum_santolallae	Solanum_laxissimum	yes
Solanum_savanillense	Solanum_savanillense	no
Solanum_scabrifolium	Solanum_scabrifolium	no
Solanum_scabrum	Solanum_scabrum	no
Solanum_schenckii	Solanum_schenckii	no
Solanum_schimperianum	Solanum_schimperianum	no
Solanum_schlechtendalianum	Solanum_schlechtendalianum	no
Solanum_schomburgkii	Solanum_schomburghii	no
Solanum_sciadostylis	Solanum_sciadostylis	no
Solanum_sejunctum	Solanum_sejunctum	no
Solanum_semiarmatum	Solanum_semiarmatum	no
Solanum_sendtnerianum	Solanum_sendtnerianum	no
Solanum_serpens	Solanum_serpens	no
Solanum_sessiliflorum	Solanum_sessiliflorum	no
Solanum_sessilistellatum	Solanum_nigriviolaceum	yes
Solanum_shirleyanum	Solanum_shirleyanum	no
Solanum_sibundoyense	Solanum_sibundoyense	no
Solanum_simile	Solanum_simile	no
Solanum_sisymbriifolium	Solanum_sisymbriifolium	no
Solanum_sitiens	Solanum_sitiens	no
Solanum_sparsipilum	Solanum_brevicaule	yes
Solanum_spegazzinii	Solanum_brevicaule	yes
Solanum_stagnale	Solanum_stagnale	no
Solanum_stellativelutinum	Solanum_stellativelutinum	no
Solanum_stelligerum	Solanum_stelligerum	no
Solanum_stenandrum	Solanum_stenandrum	no
Solanum_stenophyllidium	Solanum_stenophyllidium	no
Solanum_stenopterum	Solanum_stenopterum	no
Solanum_stoloniferum	Solanum_stoloniferum	no
Solanum_stramoniifolium	Solanum_stramoniifolium	no
Solanum_stuckertii	Solanum_stuckertii	no
Solanum_stupefactum	Solanum_stupefactum	no
Solanum_sturtianum	Solanum_sturtianum	no
Solanum_subinerme	Solanum_subinerme	no
Solanum_subpanduratum	Solanum_colombianum	yes
Solanum_sucrense	Solanum_brevicaule	yes
Solanum_supinum	Solanum_supinum	no
Solanum_symonii	Solanum_symonii	no
Solanum_taeniotrichum	Solanum_taeniotrichum	no
Solanum_talarense	Solanum_talarense	no
Solanum_tampicense	Solanum_tampicense	no
Solanum_tarijense	Solanum_berthaultii	yes
Solanum_tegore	Solanum_tegore	no
Solanum_tenuipes	Solanum_tenuipes	no
Solanum_tenuisetosum	Solanum_tenuisetosum	no
Solanum_tenuispinum	Solanum_tenuispinum	no
Solanum_terminale	Solanum_terminale	no
Solanum_ternatum	Solanum_ternatum	no
Solanum_tetramerum	Solanum_tetramerum	no
Solanum_tetrathecum	Solanum_tetrathecum	no
Solanum_thelopodium	Solanum_thelopodium	no
Solanum_thomasiifolium	Solanum_thomasiifolium	no
Solanum_thruppii	Solanum_coagulans	no
Solanum_tobagense	Solanum_tobagense	no
Solanum_toliaraea	Solanum_toliaraea	no
Solanum_tomentosum	Solanum_tomentosum	no
Solanum_torvum	Solanum_torvum	no
Solanum_tredecimgranum	Solanum_furcatum	no
Solanum_tribulosum	Solanum_tribulosum	no
Solanum_tridynamum	Solanum_houstonii	no
Solanum_triflorum	Solanum_triflorum	no
Solanum_tripartitum	Solanum_tripartitum	no
Solanum_trisectum	Solanum_trisectum	no
Solanum_tuberosum	Solanum_tuberosum	no
Solanum_tudununggae	Solanum_tudununggae	no
Solanum_tundalomense	Solanum_colombianum	yes
Solanum_turneroides	Solanum_turneroides	no
Solanum_ugentii	Solanum_brevicaule	yes
Solanum_uncinellum	Solanum_uncinellum	no
Solanum_unilobum	Solanum_unilobum	no
Solanum_ursinum	Solanum_ursinum	no
Solanum_urticans	Solanum_urticans	no
Solanum_vaccinioides	Solanum_vaccinioides	no
Solanum_valdiviense	Solanum_valdiviense	no
Solanum_vansittartense	Solanum_vansittartense	no
Solanum_vernei	Solanum_vernei	no
Solanum_verrucosum	Solanum_verrucosum	no
Solanum_vescum	Solanum_vescum	no
Solanum_vespertilio	Solanum_vespertilio	no
Solanum_vestissimum	Solanum_vestissimum	no
Solanum_viarum	Solanum_viarum	no
Solanum_vicinum	Solanum_vicinum	no
Solanum_villosum	Solanum_villosum	no
Solanum_violaceimarmoratum	Solanum_violaceimarmoratum	no
Solanum_violaceum	Solanum_violaceum	no
Solanum_viridifolium	Solanum_viridifolium	no
Solanum_wallacei	Solanum_wallacei	no
Solanum_wendlandii	Solanum_wendlandii	no
Solanum_whalenii	Solanum_whalenii	no
Solanum_wrightii	Solanum_wrightii	no
Solanum_yungasense	Solanum_chacoense	yes
Streptosolen_jamesonii	Streptosolen_jamesonii	no
Symonanthus_aromaticus	Symonanthus_aromaticus	no
Symonanthus_bancroftii	Symonanthus_bancroftii	no
Trianaea_sp	Trianaea_sp	no
Trianaea_speciosa	Trianaea_speciosa	no
Tsoala_tubiflora	Tsoala_tubiflora	no
Tzeltalia_amphitricha	Tzeltalia_amphitricha	no
Tzeltalia_calidaria	Tzeltalia_calidaria	no
Vassobia_breviflora	Vassobia_breviflora	no
Vassobia_dichotoma	Vassobia_dichotoma	no
Vestia_foetida	Cestrum_sp	yes
Vestia_lycioides	Vestia_foetida	no
Withania_coagulans	Withania_coagulans	no
Withania_somnifera	Withania_somnifera	no
Witheringia_cuneata	Cuatresia_cuneata	no
Witheringia_macrantha	Witheringia_macrantha	no
Witheringia_meiantha	Witheringia_meiantha	no
Witheringia_solanacea	Witheringia_solanacea	no
Solanum_rufistellatum	Solanum_rufistellatum	yes
Solanum_paucispinum	Solanum_paucispinum	yes
Solanum_mirum	Solanum_mirum	no
Solanum_caumii	Solanum_caumii	no
Solanum_albertii	Solanum_albertii	no
Solanum_labyrinthinum	Solanum_labyrinthinum	no
Solanum_semisucculentum	Solanum_semisucculentum	no
Solanum_ratale	Solanum_ratale	no
Solanum_memaoyanum	Solanum_memaoyanum	no
Solanum_spnov	Solanum_spnov	yes
Solanum_vanuatuense	Solanum_vanuatuense	no
Solanum_pseudopedunculatum	Solanum_pseudopedunculatum	no
Solanum_acanthocarpum	Solanum_acanthocarpum	yes
Solanum_callium	Solanum_spirale	no
Solanum_dallachii	Solanum_magnifolium	no
Soalnum_dianthophorum	Solanum_ellipticum	yes
Solanum_hirsutum	Solanum_hirsutum	yes
Solanum_mankiense	Solanum_torricellense	no
Solanum_cladotrichotum	Lycianthes_cladotrichota	yes
Soalnum_moszkowskii	Lycianthes_moszkowskii	yes
Solanum_oliverianum	Lycianthes_oliverianum	yes
Solanum_prinophylum	Solanum_prinophyllum	no
Solanum_seitheae	Solanum_echinatum	yes
Solanum_stuartianum	Solanum_stuartianum	yes
Solanum_turraeifolium	Solanum_discolor	yes
Solanum_umbonatum	Lycianthes_umbonatum	yes
Solanum_villaricense	Solanum_guaraniticum	yes
Solanum_yirrkalense	Solanm_discolor	yes
Solanum_aenictum	Solanum_palinacanthum	yes
Solanum_apaense	Solanum_rhytidoandrum	yes
Solanum_aripoense	Solanum_erythrotrichum	yes
Solanum_auctosepalum	Solanum_stellatiglandulosum	yes
Solanum_berteroanum	Lycianthes_fugax	yes
Solanum_blodgettii	Solanum_donianum	yes
Solanum_blumei	Lycianthes_sp.	yes
Solanum_boerhaviifolium	Solanum_laxum	yes
Solanum_boquetense	Solanum_candidum	yes
Solanum_botelhianum	Solanum_paniculatum	yes
Solanum_brusquense	Solanum_wackettii	yes
Solanum_californicum	Solanum_umbelliferum	yes
Solanum_caribaeum	Solanum_nigrescens	yes
Solanum_caumii	Solanum_caumii	no
Solanum_chiliadenium	Solanum_caripense	yes
Solanum_clavatum	Solanum_aligerum	yes
Solanum_cornutum	Solanum_rostratum	yes
Solanum_cyathocalyx	Lycianthes_cyathocalyx	yes
Solanum_davidsoniae	Cuatresia_riparia	yes
Solanum_dejectum	Lycianthes_moziniana	yes
Solanum_denticulatum	Lycianthes_denticulata	yes
Solanum_diaboli	Solanum_dasyanthum	yes
Solanum_domingense	Lycianthes_virgata	yes
Solanum_edwardsii	Solanum_cordovense	yes
Solanum_elegans	Solanum_elegans	no
Solanum_fastigiatum	Solanum_bonariense	yes
Solanum_fruticosum	Solanum_bahamense	yes
Solanum_geniculatistrigosum	Solanum_turneroides	yes
Solanum_gentlei	Solanum_schlechtendalianum	yes
Solanum_gracillimum	Solanum_hirtellum	yes
Solanum_graniticola	Solanum_graniticola	no
Solanum_guanicense	Solanum_campechiense	yes
Solanum_guianense	Lycianthes_guianense	yes
Solanum_haematocladum	Solanum_rhytidoandrum	yes
Solanum_haitense	Lycianthes_sp	yes
Solanum_heterophyllum	Solanum_diversifolium	yes
Solanum_hirsutissimum	Solanum_pectinatum	yes
Solanum_huallagense	Solanum_mite	yes
Solanum_huitlanum	Solanum_candidum	yes
Solanum_hunzikeri	Solanum_hunzikeri	no
Solanum_hydroides	Solanum_hydroides	no
Solanum_hypiodes	Solanum_venosum	yes
Solanum_hypodischroum	Solanum_mesopliarthrum	yes
Solanum_hypomalacophyllum	Solanum_oblongifolium	yes
Solanum_iraniense	Solanum_cylindricum	yes
Solanum_jasminifolium	Solanum_viscosissimum	yes
Solanum_jelskii	Lycianthes_jelskii	yes
Solanum_jubeba	Solanum_paniculatum	yes
Solanum_juripeba	Solanum_subinerme	yes
Solanum_krauseanum	Solanum_valdiviense	yes
Solanum_labyrinthinum	Solanum_labyrinthinum	no
Solanum_lanigerum	Solanum_subumbellatum	yes
Solanum_longepedunculatum	Lycianthes_sp.	yes
Solanum_macrodon	Lycianthes_biflora	yes
Solanum_macroscolum	Solanum_angustifolium	yes
Solanum_madrense	Solanum_ferrugineum	yes
Solanum_manoelii	Solanum_paniculatum	yes
Solanum_mariannae	Solanum_leptostachys	yes
Solanum_mariannense	Solanum_repandum	yes
Solanum_marmoratum	Solanum_marmoratum	no
Solanum_meloncillo	Solanum_juvenale	yes
Solanum_memaoyanum	Solanum_memaoyanum	no
Solanum_mitratum	Lycianthes_heteroclita	yes
Solanum_molestum	Solanum_hirtum	yes
Solanum_molinum	Solanum_lanceolatum	yes
Solanum_moricandii	Solanum_stagnale	yes
Solanum_nocturnum	Lycianthes_lenta	yes
Solanum_nudatum	Solanum_nudatum	no
Solanum_ochraceoferrugineum	Solanum_rudepannum	yes
Solanum_orientale	Solanum_oocarpum	yes
Solanum_ovandense	Solanum_appendiculatum	yes
Solanum_patameense	Solanum_viride	yes
Solanum_peckii	Witheringia_solanacea	yes
Solanum_pedunculare	Lycianthes_moziniana	yes
Solanum_pelliceum	Solanum_velleum	yes
Solanum_phyllanthum	Solanum_montanum	yes
Solanum_physalidicalyx	Solanum_tweedianum	yes
Solanum_poeppigianum	Solanum_valdiviense	yes
Solanum_polyanthemum	Solanum_schimperianum	yes
Solanum_pseudomegalochiton	Solanum_megalochiton	yes
Solanum_pseudopedunculatum	Solanum_pseudopedunculatum	no
Solanum_pteropodum	Solanum_oblongifolium	yes
Solanum_pulchellum	Solanum_sinuatirecurvum	yes
Solanum_quercifolium	Solanum_tampicense	yes
Solanum_quinquangulare	Solanum_acerifolium	yes
Solanum_ratale	Solanum_ratale	no
Solanum_reflexum	Solanum_aculeatissimum	yes
Solanum_salviifolium	Solanum_gardneri	yes
Solanum_savaiense	Solanum_viride	yes
Solanum_schwackeanum	Solanum_schwackei	yes
Solanum_semisucculentum	Solanum_semisucculentum	no
Solanum_siparunoides	Solanum_aturense	yes
Solanum_sordidum	Solanum_subumbellatum	yes
Solanum_stellatum	Solanum_asperolanatum	yes
Solanum_styraciflorum	Solanum_artense	yes
Solanum_subcordatum	Solanum_megalonyx	yes
Solanum_subscandens	Solanum_cordifolium	yes
Solanum_subulatum	Solanum_schumannianum	yes
Solanum_symonianum	Lycianthes_sp.	yes
Solanum_tiinae	Solanum_tiinae	no
Solanum_torreyi	Solanum_dimidiatum	yes
Solanum_toxicarum	Solanum_stramoniifolium	yes
Solanum_tucumanense	Solanum_pseudocapsicum	yes
Solanum_tumo	Solanum_vestissimum	yes
Solanum_tweedieanum	Solanum_tweedianum	yes
Solanum_vagum	Solanum_giganteum	yes
Solanum_vanheurckii	Solanum_acanthodes	yes
Solanum_vanuatuense	Solanum_vanuatuense	no
Solanum_violaceistriatum	Solanum_polytrichostylum	yes
Solanum_virgatum	Solanum_gracile	yes
Solanum_vulpinum	Solanum_asperolanatum	yes
Solanum_williamsii	Solanum_velutinum	yes
Solanum_yapacaniense	Solanum_nemorense	yes
Solanum_auriculatum	Solanum_mauritianum	yes
Solanum_bipedicellatum	Solanum_gardneri	yes
Solanum_caelicola	Solanum_caelicolum	yes
Solanum_celebense	Solanum_celebense	no
Solanum_fragans	Solanum_diploconos	yes
Solanum_rubrum	Solanum_villosum	yes
Solanum_sancthae-catharinae	Solanum_sanctae-catharinae	no
Solanum_sancthae-marthae	Solanum_sancthae-marthae	no
